R 1920 1080


         NO ./textures/bluestone.png
   SO ./textures/colorstone.png
  WE ./textures/purplestone.png
EA ./textures/redbrick.png
S ./textures/barrel.png

F ./textures/wood.png

C ./textures/greystone.png


        1111111111111111111111111
        1000000000110000000000001
        1011000001110000002000001
        1001000000000000000000001
111111111011000001110000000000001
100000000011000001110111110111111
11110111111111011100000010001
11110111111111011101010010001
11000000110101011100000010001
10002000000200001100200010201
1000000000000W001101010010001
110000011101010111110111100011
11110111 1110101 101111010001
11111111 1111111 111111111111


